8 8 8 8 8 8 8 8 8 8 8 8 8 8 8
8 0 0 5 0 9 0 0 0 0 0 0 0 9 8
8 0 0 0 0 9 0 0 9 0 0 0 0 0 8
8 0 0 0 1 9 0 0 9 0 9 9 9 1 8
8 0 9 0 9 0 0 0 0 9 0 0 9 0 8
8 0 0 0 9 0 0 9 9 9 9 9 0 0 8
8 0 0 0 0 9 9 9 0 9 9 9 0 0 8
8 0 9 0 0 0 0 0 9 0 9 0 9 0 8
8 9 9 0 9 9 0 0 0 0 9 9 9 9 8
8 0 0 0 0 0 0 0 0 0 0 0 0 0 8
8 0 0 1 0 9 9 0 9 0 5 0 0 0 8
8 0 0 9 0 9 0 0 9 0 0 0 0 9 8
8 5 0 0 0 0 0 9 9 0 9 0 9 0 8
8 0 9 0 0 0 0 0 0 0 0 9 9 9 8
8 9 0 0 0 0 0 1 9 9 0 9 0 1 8
8 0 0 9 0 9 0 0 0 0 0 0 1 0 8
8 8 8 8 8 8 8 8 8 8 8 8 8 8 8